_______________________________________________________________
_______________________________________________________________
_______________________________________________________________
_______________________________________________________________
_______________________________________________________________
_______________________________________________________________
_____________________________00000_____________________________
_____________________________0___0_____________________________
_____________________________0___0_____________________________
_____________________________0___000000000000000000000_________
_____________________________0___0______________0______________
_____________________000000000___0______________0______________
_____________________0___________0______________0______________
_____________________0___________0______________0______________
_____________________0___________0______________0______________
_______________0000000___________0000000000000000______________
_______________0_____0__________________________0______________
_______________0_____0__________________________0______________
_____________________0______________________000000000__________
_____________________00000000000____________0___0______________
_____________________0_________000000000000000000______________
_____________________0_________0_______________0_______________
_____________________0_________0_______________0_______________
_____________________0_________0_______________0_______________
_____________________0_________0000000000000000000000__________
_____________________0_________0____________0__________________
_____________________00000000000____________0__________________
_______________________________0____________0__________________
__________________________000000____________0__________________
____________________________________________00000000___________
____________________________________________0__________________
____________________________________________0__________________
________________________________0000000000000__________________
_______________________________________________________________
_______________________________________________________________
_______________________________________________________________
_______________________________________________________________
_______________________________________________________________
_______________________________________________________________
_______________________________________________________________
_______________________________________________________________
_______________________________________________________________
_______________________________________________________________
_______________________________________________________________
_______________________________________________________________
_______________________________________________________________
_______________________________________________________________
_______________________________________________________________
_______________________________________________________________
_______________________________________________________________
_______________________________________________________________
_______________________________________________________________
_______________________________________________________________
_______________________________________________________________
_______________________________________________________________
_______________________________________________________________
_______________________________________________________________
_______________________________________________________________
_______________________________________________________________
_______________________________________________________________
_______________________________________________________________
_______________________________________________________________
_______________________________________________________________
_______________________________________________________________